- - - - - - - - g
- - - - - - - - -
- - - - - - - - -
# # # # # # # # -
- - - - - - - - -
- - - s - - - - -