- - - - - - - - g
- - - - - - - - -
- - - - - - - - -
- # # # # # # # #
- - - - - - - - -
- - - s - - - - -