- - - - - - - - g
- - - - - - - - -
- - - - - - - - -
- # # # # # # # -
- - - - - - - - -
- - - s - - - - -